4 5
1 0 0 0 0
0 0 0 0 0
0 0 0 0 0
0 0 0 0 0
2 0 0 0 0
0 0 0 0 0
0 0 0 0 2
4 0 0 0 0
0 0 0 0 0
0 0 0 0 0
0 0 0 0 0
0 0 0 0 3
3 1 3 4 0
0 0 0 0 0
0 0 0 0 0
0 0 0 0 0
0 0 0 0 0
0 0 0 0 0
0 0 0 0 0
3 1 2 2 0

1 -1 -1 -1 1 1 0 0
1 -1 -1 -1 1 1 0 0
1 -1 -1 -1 1 1 0 0
1 -1 -1 -1 1 1 0 0
1 -1 -1 -1 1 1 0 0
0 -1 -1 -1 1 1 0 0
1 -1 -1 -1 1 1 0 0
1 -1 -1 -1 1 1 0 0
0 -1 -1 -1 1 1 0 0
0 -1 -1 -1 1 1 0 0
11 -1 -1 -1 0 1 0 0
1 -1 -1 -1 1 1 0 0
0 -1 -1 -1 1 1 0 0
0 -1 -1 -1 1 1 0 0
0 -1 -1 -1 1 1 0 0
11 -1 -1 -1 0 1 0 0
1 -1 -1 -1 1 1 0 0
1 -1 -1 -1 1 1 0 0
10 -1 -1 -1 1 0 0 0
0 -1 -1 -1 1 1 0 0
1 -1 -1 -1 1 1 0 0
1 -1 -1 -1 1 1 0 0
1 -1 -1 -1 1 1 0 0
1 -1 -1 -1 1 1 0 0
1 -1 -1 -1 1 1 0 0

1 -1 -1 -1 1 1 0 0
0 -1 -1 -1 1 1 0 0
0 -1 -1 -1 1 1 0 0
0 -1 -1 -1 1 1 0 0
1 -1 -1 -1 1 1 0 0
1 -1 -1 -1 1 1 0 0
1 -1 -1 -1 1 1 0 0
0 -1 -1 -1 1 1 0 0
1 -1 -1 -1 1 1 0 0
1 -1 -1 -1 1 1 0 0
1 -1 -1 -1 1 1 0 0
1 -1 -1 -1 1 1 0 0
1 -1 -1 -1 1 1 0 0
0 -1 -1 -1 1 1 0 0
6 2 2 -1 1 1 0 0
1 -1 -1 -1 1 1 0 0
1 -1 -1 -1 1 1 0 0
1 -1 -1 -1 1 1 0 0
1 -1 -1 -1 1 1 0 0
6 1 1 -1 1 1 0 0
0 -1 -1 -1 1 1 0 0
0 -1 -1 -1 1 1 0 0
10 -1 -1 -1 1 0 0 0
1 -1 -1 -1 1 1 0 0
0 0
0 4